R      1920   1080 
NO                 ./textures/colorstone.xpm
SO   ./textures/greystone.xpm

WE     ./textures/bluestone.xpm
EA   ./textures/wood.xpm

S                ./textures/barrel.xpm
F    255  ,  248  ,  220




C 125   ,206,  250

        1111111111111111111111111
111111111000000001222222202222221
        1011000001000220000000021
        1001000001000220000000021
111111111011000010000220000000021
100000000011000101000000000111111
11110000000000001000000000001
11110111111110000000000000001
1100001     10011100000000001
10000011111110001100000000001
10000000000000000000000N00001
1100000111010101111100000000111
11110001 1110101 101000000001
11111111 1111111 111111111111