
R 1920 1080
NO           ./textures/p.xpm
SO   ./textures/Slime1.xpm
WE     ./textures/wood.xpm


F    255,20,  250
C 125   ,206,  250

        1111111111111111111111111
        1000000000110000000000001
        1011000001110000012000001
        1001000000000S02001000001       
111111111011000001110000010000001
100000000011000001110111111111111
11110111111111011100000010001
11110111111111011101010010001
11000000110101011100000000001
10002000000000001100000010001
10000000000000001101010010001
110000011101010111110111100111
11110111 1110101 101111010001
11111111 1111111 111111111111