R 1500 1500
NO           ./textures/test2.xpm
SO   ./textures/Slime1.xpm
WE     ./textures/wood.xpm
EA   ./textures/test2.xpm
S                ./textures/barrel.xpm
F    255  ,20,  250
C 125   ,206,  250
                                
    
        1111111111111111111111111       1111111111111111  
111111111000000001000222000000001       1000000000000001
        1011000001000022000000001       1111111111111111
        1001000001000000000000001
111111111011000010000000000000001
100000000011000101000000000111111
111100000000000010000E0000001
11110111111110000000000000001
1100001     10011100000000001
10000011111110001100000000001
10000000000000000000000000001
1100000111010101111100000000111
11110001 1110101 101002000001
11111111 1111111 111111111111
                            
11111111111111111111111111111
100011111111111
11111
